+---------------------------------------------+
|P                                            |
|---------------- +-----+--+----+---+  +-- |  |
|                 |     |  |    |   |  |   |  |
|  |  +-----+--+--+  |  |  +--- |   |  |   |  |
|  |  |        |  |  |  |  |        |  +---+  |
|  |  |  |  |  |     |  |  |------- +--+   |  |
|  |  |  |  +--------+        |     |      |  |
|        |           +--------+ ----+ -----+  |
| -------|  +-----+           |               |
|     |  |  |     |---------  +---- |   +--+ -|
|  |     |  |  |  |           |     |   |  |  |
|  |-----+  |  |  |  +-----+  +-----+   |  |  |
|  |     |  |  |  |  |     |  |            +--|
|     |  |  |  |  |  |  F  |  +--------       |
|  |--+--|  |  |  |  +---- |  |         |  |  |
|  |     |        |  |        |    |----+  |  |
|  |  |  +--------+--+  ------+    |       |  |
|  |  |                       |    +-------+  |
|  |  -----------+  +--------------+          |
|  |             |  |              +--- |  |  |
|  +----------+  |  +--------+  |  |    |  |  |
|  |    |     |  |           |  |  |          |
|  | ---+---- |  +-----------+  |  | ---------|
|             |  ||    ||    |  |             |
|----+ ------ |     ||    ||    | ----- +-----|
|    |        +-----+-----------+       |     |
| ---+-----         |           | ------+---- |
|                                             |
+---------------------------------------------+