+---------------------------------------------+
|*                                            |
|---------------  +-----+--+  --+---+--+   |  |
|                 |     |  |    |   |  |   |  |
|  |  +-----+--+--+  |  |  +----|   |  |   |  |
|  |  |        |  |  |  |  |        |  +---+  |
|  |  |  |  |  |     |  |  |------  +--+   |  |
|  |  |  |  +--------+        |     |      |  |
|        |           +--------+  ---+  ----+  |
|  ------|  +-----+           |               |
|     |  |  |     |---------  +---  |   +--+  |
|  |     |  |  |  |           |     |   |  |  |
|  |------  |  |  |  +-----+  +-----+   |  |  |
|  |     |  |  |  |  |     |  |            +--|
|     |  |  |  |  |  |  F  |  +-------        |
|  |--+--|  |  |  |  +---  |  |         |  |  |
|  |     |        |  |        |    |----+  |  |
|  |  |  +--------+--+  ------+    |       |  |
|  |  |                       |    +-------+  |
|  |  -----------+  +--------------+          |
|  |             |  |              +--  |  |  |
|  +----------+  |  +--------+  |  |    |  |  |
|  |    |     |  |           |  |  |          |
|  |  --+--   |  +-----------+  |  |  --------|
|             |  |     |     |  |             |
|----+  ---   |     |     |     |  ---  +-----|
|    |        +-----+-----------+       |     |
|  --+-----         |           |  -----+---  |
|                                             |
+---------------------------------------------+