+---------------------------------------------+
|****************                             |
|----------------*+-----+--+----+---+  +-- |  |
|     ************|     |  |    |   |  |   |  |
|  | *+-----+--+--+  |  |  +--- |   |  |   |  |
|  | *|  *     |  |  |  |  |        |  +---+  |
|  | *| *|* |  |     |  |  |------- +--+   |  |
|  | *|**| *+--------+        |     |      |  |
|     ***|  *******  +--------+ ----+ -----+  |
| -------|  +-----+*********  |               |
|     |  |  |     |---------* +---- |   +--+ -|
|  |     |  |  |  |        *  |     |   |  |  |
|  |-----+  |  |  |  +-----+* +-----+   |  |  |
|  |     |  |  |  |  |     |* |            +--|
|     |  |  |  |  |  |  ** |* +--------       |
|  |--+--|  |  |  |  +----*|* |         |  |  |
|  |     |        |  |     *  |    |----+  |  |
|  |  |  +--------+--+  ------+    |       |  |
|  |  |                       |    +-------+  |
|  |  -----------+  +--------------+          |
|  |             |  |              +--- |  |  |
|  +----------+  |  +--------+  |  |    |  |  |
|  |    |     |  |           |  |  |          |
|  | ---+---- |  +-----------+  |  | ---------|
|             |  ||    ||    |  |             |
|----+ ------ |     ||    ||    | ----- +-----|
|    |        +-----+-----------+       |     |
| ---+-----         |           | ------+---- |
|                                             |
+---------------------------------------------+
